NO ./assets/textures/so-long/gold-brick.png
SO ./assets/textures/so-long/diamond-rug.png
WE ./assets/textures/error-tile-colors/error-tile.png
EA ./assets/textures/error-tile-colors/error-tile_GREEN.png

F 50,50,66
C 22,120,255

1111111111111
1000000000001
1000000000001
1000000000001
1000000000001
1000000000001
1000000S00001
1000000000001
1000000000001
1000000000001
1000000000001
1000000000001
1000000000001
1000000000001
1000000000001
1111111111111
