NO ./assets/textures/so-long/gold-brick.png
SO ./assets/textures/so-long/diamond-rug.png
WE ./assets/textures/error-tile-colors/error-tile.png
EA ./assets/textures/error-tile-colors/error-tile_GREEN.png

F 50,50,66
C 22,120,255

11111111111111111111111111111111111
10000000000000000000000000000000001
10000000000000000000000000000000001
100000000000000E0000000000000000001
10000000000000000000000000000000001
10000000000000000000000000000000001
10000000000000000000000000000000001
11111111111111111111111111111111111
