NO ./assets/textures/so-long/gold-brick.png
SO ./assets/textures/so-long/diamond-rug.png
WE ./assets/textures/error-tile-colors/error-tile.png
EA ./assets/textures/error-tile-colors/error-tile_GREEN.png

F 22,120,255
C 50,50,66

11111111
10100001
10100001
10100001
10000001
10001001
10000001
11111111
