
	1111111111
	1100100001
	1010000111
	10100N01
 11110001001
 10010100111
1100D00011
1000D001
1000D001
11111111


NO	./assets/textures/so-long/gold-brick.png
SO	./assets/textures/so-long/diamond-rug.png
WE	./assets/textures/error-tile-colors/error-tile.png
EA	./assets/textures/error-tile-colors/error-tile_GREEN.png

F 50,50,66
C 22,120,255

